#0;room1.txt
0   m   G 
WWWWWWWSWW
    s  S  
hWSWWWWWWW
  S   B   
WWWWSWW WW
B   S  s  
WWWWWSWWWW
   b S H  
WWWWWWWWWW